00000000111100000000
00000001000010000000
00000001000010000000
00000001000010000000
00011111100111111000
01110000000000101110
01000000000000100010
11000000000000100011
11100111111111100001
10000000000000100001
10000000000000000001
10000000000000000001
10000000000000000001
10000000000000100001
11101111111111111111
11000000000000000011
01000000000000000010
00111111000011111100
00000001111110000000