1111111
1030091
1030001
1030001
1090201
1000001
1411111