32,196,32|150,150,255
1,1,1,1,1,1,1,1
1,0,0,0,0,0,0,1
1,0,9,0,0,9,0,1
1,0,0,0,0,0,0,1
2,0,0,0,0,0,0,4
3,0,0,0,0,0,0,3
4,0,0,0,0,0,0,2
1,1,1,1,1,0,0,1
1,0,0,0,0,0,0,1
1,0,0,4,4,4,4,1
1,0,0,0,0,0,0,1
1,0,0,0,0,0,0,1
1,0,3,0,0,2,0,1
1,0,0,0,0,0,0,1
1,1,1,1,1,1,1,1