1111111
1030001
1030001
1030001
1000201
1000001
1411111