128,128,128|0,0,0
1,1,1,1,1,1,1
1,0,3,0,0,9,1
1,0,3,0,0,0,1
1,0,3,0,0,0,1
1,0,9,0,2,0,1
1,0,0,0,0,0,1
1,4,1,1,1,1,1