11111111
10000001
10900901
10000001
20000004
30000003
40000002
11111001
10000001
10044441
10000001
10000001
10300201
10000001
11111111